10 20
MMMMMMMMMMMMMMMMMMMM
MVVVVVVVVVVVVTVVVVVM
MVVVVVVVVVVVVVVVVVVM
MVVVVVVVVVVVVVVVVVVM
MVVVVVKVVVVVVVVSVVVM
MVVVVVVVVVVVVVVVVVVM
MVHVVVVDVVVVVVVVVVVM
MVVVVVVVVVVVVVVVVVVM
MVVVVVVVVVVVVVVVVVVM
MMMMMMMMMMMMMMMMMMMM
