10 20
11111111111111111111
10000000000006000001
10000000000000000001
10000800000007000001
100000400000000500D1
10000000000000011191
10300002000000010001
10000000000000010001
1000000000000009D001
11111111111111111111
