10 10
MMMMMMMMMM
MVVVVMVVVM
MVVVVMVGVM
MVVVVMVVVM
MVVVVMVVVM
MVVVVMVVVM
MVVVVMVVVM
MVVBVMVVVM
MVVVVMVVVM
MMMMMMMMMM