20 30
111111111111111111111111111111
100001300000600000000000100051
111001080000000711111120100001
180001111111111110000100100001
100001000001000000000100180001
101101701001080001200100100001
100001001041000001000000100081
100701021111111021111111100001
100001000801000000000000170001
111001000001011111111100100201
180001020001000000000100111101
100001011111011111101110600101
100001007001617000000010000001
100001000601110000111111111111
100111006000010000000000010001
100701000000011111111112000001
100001002000000000000010010001
111001111111110000000011116001
100000000000000000000000000001
111111111111111111111111111111