10 20
11111111111111111111
10000000000006000001
10000000000000000001
10000800000007000001
10000040000000050001
10000000000000000001
10300002000000000001
10000000000000000001
10000000000000000001
11111111111111111111
