20 30
MMMMMMMMMMMMMMMMMMMMMMMMMMMMMM
MVVVVMHVVVVVTVVVVVVVVVVVMVVVSM
MMMVVMVGVVVVVVVBMMMMMMDVMVVVVM
MGVVVMMMMMMMMMMMMVVVVMVVMVVVVM
MVVVVMVVVVVMVVVVVVVVVMVVMGVVVM
MVMMVMBVMVVMVGVVVMDVVMVVMVVVVM
MVVVVMVVMVKMVVVVVMVVVVVVMVVVGM
MVVBVMVDMMMMMMMVDMMMMMMMMVVVVM
MVVVVMVVVGVMVVVVVVVVVVVVMBVVVM
MMMVVMVVVVVMVMMMMMMMMMVVMVVDVM
MGVVVMVDVVVMVVVVVVVVVMVVMMMMVM
MVVVVMVMMMMMVMMMMMMVMMMVTVVMVM
MVVVVMVVBVVMTMBVVVVVVVMVVVVVVM
MVVVVMVVVTVMMMVVVVMMMMMMMMMMMM
MVVMMMVVTVVVVMVVVVVVVVVVVMVVVM
MVVBVMVVVVVVVMMMMMMMMMMDVVVVVM
MVVVVMVVDVVVVVVVVVVVVVMVVMVVVM
MMMVVMMMMMMMMMVVVVVVVVMMMMTVVM
MVVVVVVVVVVVVVVVVVVVVVVVVVVVVM
MMMMMMMMMMMMMMMMMMMMMMMMMMMMMM